1111111111111111111111111111111
1000001000000000000000001000001
1001001000000000000000001001001
1001001000000000000000001001001
1001001000111101011110001001001
1001001000100000000010001001001
1001001000100000000010001001001
1001001000100111110010001001001
1001001000100100010010001001001
2001000000100104010010000001002
1001001000100005000010001001001
2001000000100100010010000001002
1001001000100100010010001001001
1001001000100111110010001001001
1001001000100000000010001001001
1001001000100000000010001001001
1001001000111101011110001001001
1001001000000000000000001001001
1001001000000000000000001001001
1000001000000000000000001000001
1111111111111111111111111111111