11111111111111111
10000000000000001
10111111011111101
10100000000000101
10101111311110101
10101000000010101
10101010101010101
10101010001010101
10101010001010101
10101010001010101
10101011311010101
10101000000010101
10101111011110101
10100000000000101
10111111311111101
10000000000000001
11111211111211111
