111111111111111111111
200100000000000001002
110010000000000010011
101001011111100100101
100101000000100101001
100001111101100100001
101110001000100011101
100000001050100000001
101110001040100011101
100001001101111100001
100101001000000101001
101001001111110100101
110010000000000010011
200100000000000001002
111111111111111111111