111111111
100000001
101101101
101000101
103000301
101000101
101111101
100000001
121121121
