111111111111111111111111111111
100000000000000000000000000001
110010000000000000000000010011
201001111111110011111111100102
200100100000000000000001001002
110010100111111111111001010011
200000100000005400000001000002
200000100000000000000001000002
110010100111111111111001010011
200100100000000000000001001002
201001111111110011111111100102
110010000000000000000000010011
100000000000000000000000000001
111111111111111111111111111111